NO /Users/mawad/Desktop/GitCube/mandatory/images/lion.xpm
SO /Users/mawad/Desktop/GitCube/mandatory/images/brick.xpm
WE /Users/mawad/Desktop/GitCube/mandatory/images/ice3.xpm  
EA                               /Users/mawad/Desktop/GitCube/mandatory/images/ice.xpm

F 20,160,25

C 205,30,130
   
       111111111111111111111111   
      1000000000110000000000001   
     1011000001110000000000001
    10010000000000000000000011111
111111111011000001110000000000001
 10000000001100000111011  11111111
11110111111111011100000010001
11110111111111011101010010001
11000000110101011100000010001
100000000000000001100000010001
10000000000000001101010010001
11000001110101011111011111N0111
 111110111 1110101111111010001
11111111 1111111 111111111111