11111111111111
10010000000001
100100P0000001
10000000000001
10000000000001
10000000001001
10100000000001
10000000000001
11111111111111
