111111111
100000001
100000001
101101101
101101101
101101101
100000001
101101101
101101101
101101101
100000001
10P000001
111111111
