1111111111
1000000001
10000P0101
1111111111