F 235,242,249
	NO mandatory/images/ice3.xpm
  WE		 mandatory/images/ice3.xpm    
  		EA 	mandatory/images/ice3.xpm				

C          115,122,132

SO mandatory/images/ice3.xpm

111111111
100000001
100000001
101101101
101101101
101101101
100000001
101101101
101101101
101101101
100000001
10N000001
111111111
