NO images/horror/horror1.xpm
WE images/horror/horror2.xpm    
EA images/horror/horror3.xpm		
SO images/horror/horror4.xpm

F 5,5,5		
C 124,10,2

111111111
100000001
100000001
101101101
101101101
101101101
100000001
101101101
101101101
101101101
100000001
10N000001
111111111
