F 220,  201 ,0
	NO images/brick.xpm
  WE		 images/gun.xpm    
  		EA 	images/ice.xpm				

C          232 	, 209 , 22

SO images/ice3.xpm




        1111111110111111111111111
		1000000000110000000000001
		1011000001110000000000001
		1001000000000000000000001
111111111011000001110000000000001
 100000000011000001110111111111111
11110111111111011100000010001
11110111111111011101010010001
11000000110101011100000010001
100000000000000001100000010001
10000000000000001101010010001
11000001110101011111011111N0111
 111110111 1110101111111010001
11111111 1111111 111111111111